111111111111111
10C00C001000001
10C00000100C001
10C0000P0000001
10C000000000001
1000E0001000C01
111111111111111